##############################
#     T #  c        #        C
# # ##### # ####### ####### # 
# #     # # #   #   #     # # 
# ##### # ### # # ### ### # ##
# # c   #     # # #   #   #   
### ########### # # ### ##### 
#  T#           #   # #     # 
# ### ############### ##### # 
#  C# #                   #B  
# # ### ##### ####### ####### 
# #     #   #     #   #   #   
# ####### # ##### ##### # # ##
#  A  T   #     #    c  #     
##############################
